type: mettagrid.map_builder.ascii.AsciiMapBuilder.Config
map_data: |-
    ########################################
    #....#.................................#
    #.#..#......................#..........#
    #.#..#...............#.................#
    #..#.#......####.................O..#..#
    #..#.#...#..####..........#............#
    #.O..##..#..###...#....................#
    #......#..#..##....##.............##...#
    #....###......####........#....#....#..#
    #.............#.....................#..#
    #.#####................................#
    #.............................#...#....#
    #.....####.............................#
    #........#.............................#
    #........#.....###.....###.............#
    #........#.....#....m...G#.............#
    #.....#........#...a=r...#......#......#
    #.....#.............t...........##.....#
    #.....#.............&............##....#
    #.....#.............@@@@@@@@......#....#
    #.....#................................#
    #.....#.............+..................#
    #..........#...#C.......S#.............#
    #..........#...#.........#.............#
    #..........#...###.....###.............#
    #.....#....#.................#.........#
    #.....#....#..................##.......#
    #..........#...................##......#
    #..............#####............##.....#
    #..............#...#......##...O.##....#
    #..............#...#.....#.##......#...#
    #....######....#...#....##..##....##...#
    #......O..###..#...#....#....###.##....#
    #..............#...#....##.....###.....#
    #..............#.........##............#
    #.........................###..........#
    #...........................##.........#
    #......................................#
    #......................................#
    ########################################
char_to_map_name:
  "#": wall
  ".": empty
  "O": oxygen_extractor
  "G": germanium_extractor
  "+": junction
  "C": carbon_extractor
  "S": silicon_extractor
  "@": agent.agent
  "&": c:hub
  "=": c:chest


  "a": c:aligner
  "r": c:scrambler
  "m": c:miner
  "t": c:scout
