type: mettagrid.map_builder.ascii.AsciiMapBuilder.Config
map_data: |-
    ########################################
    #..................................#...#
    #.#......S................#............#
    #.#...O...............G.....#....#...#.#
    #..#.........####...................#..#
    #..#...#.....######..........#...O.....#
    #......#...######.#.......#............#
    #......#...######.##.............##....#
    #....###......####....G...#....#....#..#
    #............#......................#..#
    #.#####.S................O.............#
    #.............................#...#....#
    #.....####.C....O......................#
    #C.......#.......................G.....#
    #......C.#.....###.....###.............#
    #........#.....#O...m...G#...........O.#
    #.....#........#...a=r...#......#......#
    #.....#.....G.......t...........##.....#
    #....C#.............&....S.......##....#
    #.....#.............@@@@@@@@......#....#
    #.....#....C...........................#
    #.....#.............+..................#
    #..........#...#C.......S#.......G.....#
    #........G.#...#.........#.............#
    #..........#...###.....###.............#
    #.....#....#.................#.........#
    #.....#....#..................##...O...#
    #..........#..C..+.........G...##......#
    #..............#####............##.....#
    #..............#...#......##.....##....#
    #...C..........#...#.....#.##......#...#
    #....######....#...#....##..##....##...#
    #.........###..#...#....#....###.##....#
    #..............#...#....##.....###.....#
    #..C....S......#.........##............#
    #.........................###..........#
    #...................G.......##........O#
    #.....S................................#
    #..............C..................S....#
    ########################################
char_to_map_name:
  "#": wall
  ".": empty
  "O": oxygen_extractor
  "G": germanium_extractor
  "+": junction
  "C": carbon_extractor
  "S": silicon_extractor
  "@": agent.agent
  "&": c:hub
  "=": c:chest
  "a": c:aligner
  "r": c:scrambler
  "m": c:miner
  "t": c:scout
