type: mettagrid.map_builder.ascii.AsciiMapBuilder.Config
map_data: |-
    ########################################
    #..................................#...#
    #.#....S..................#............#
    #.#................G........#....#...#.#
    #..#.........####...................#..#
    #..#...#.....######..........#...O.....#
    #......#...######.#.......#............#
    #......#...######.##.............##....#
    #....###......####........#....#....#..#
    #....C.......#........G.............#..#
    #.#####................................#
    #.............................#...#....#
    #.....####...........C.................#
    #....S...#........................O....#
    #........#.....###.....###.............#
    #........#.....#O...m...G#.............#
    #.....#........#.@.a=r.@.#......#......#
    #.....#.............t..@........##.....#
    #.....#...C......@..&............##....#
    #.....#.............@..@..........#....#
    #.....#..........@.......@.............#
    #.....#.............+...............G..#
    #..........#...#C.......S#.....C.......#
    #......O...#...#.........#..........O..#
    #..........#...###.....###.............#
    #.....#....#.................#.....S...#
    #.....#....#........G.........##.......#
    #..........#...................##......#
    #..............#####............##.....#
    #.....S........#...#......##.....##....#
    #..............#...#.....#.##......#...#
    #....######....#...#....##..##....##...#
    #.........###..#...#....#....###.##....#
    #..............#...#....##.....###.....#
    #..............#.........##............#
    #........C................###......G...#
    #...........................##.........#
    #...............O......................#
    #......................................#
    ########################################
char_to_map_name:
  "#": wall
  ".": empty
  "O": oxygen_extractor
  "G": germanium_extractor
  "+": junction
  "C": carbon_extractor
  "S": silicon_extractor
  "@": agent.agent
  "&": hub
  "=": chest


  "a": aligner_station
  "r": scrambler_station
  "m": miner_station
  "t": scout_station
