type: mettagrid.map_builder.ascii.AsciiMapBuilder.Config
map_data: |-
  ########################################
  ########################################
  ########################################
  #####.G#################################
  #####.##################################
  ####...###..#####...#######.####..######
  #####........####.O.######...###..######
  #######.####..###...#.###..G..##...#####
  #########..#..#..##.............+..#####
  #######..#.#.##.##...#########....######
  #######.+#...................#....######
  ######.....C...............O.##....#####
  ######.#.#...................##....#####
  #####...##...................#....######
  #####...##...................##.########
  #####...##...................##...######
  ######..##.........+.........##.+.######
  ########.#......@..@....@....#....######
  ########........................+..#####
  ######...........@.&.@.............#####
  ######..#..........m...............#####
  #####..###......@..@.@.......###..######
  #####..###........a=r........##..#######
  #####..###.........t.........#..########
  #####...##...................#..########
  ######..##...................#.#########
  #######..#...................#.....#####
  #####....#.G...............S.#.....#####
  #####...##...................#.....#####
  #######.##.#.#####...#########....######
  #######.#..#..#..###.####.........######
  #######.####..#.##...####.....S...######
  #######....###........#####........#####
  ######...C...##.###.....#####...#.######
  #######......######..#..################
  ########################################
  ########################################
  ########################################
  ########################################
  ########################################
char_to_map_name:
  "#": wall
  ".": empty
  "@": agent.agent
  "+": junction
  "&": hub
  "=": chest
  "G": germanium_extractor
  "S": silicon_extractor
  "O": oxygen_extractor
  "C": carbon_extractor
  "a": aligner_station
  "r": scrambler_station
  "m": miner_station
  "t": scout_station
