type: mettagrid.map_builder.ascii.AsciiMapBuilder.Config
map_data: |-
  ##############################################################################################################
  ##############################################################################################################
  ##############################################################################################################
  ##############################################################################################################
  ##############################################################################################################
  #####@.#@.###@#..######..###########.....##.####....###...#..#####.####...####..##################..##########
  #####............####....#####..#............###....##.......####...##....###...#########..######....#########
  ######............###...####......C.................##.....................#..O.#####......######...##########
  ######.......###.##...######.#......#...............###.......#.#.........#.....#####...#..#######..##.#######
  #######......##.##..G.#......#....###.....##....##.####......#.######.....##.##.#####...######..##..#...######
  #######.................#....##.........##......#######..####...######.....##....##.#.....###....#.###...#####
  ######......##..##......####..#...###.#..##.C.#######.#...###..##..###....###...##....#.+.####.#.#.###...#####
  ######.....###.##........##..##...###.#####...#######.....#....##..#......#.........#.#....#####....##.#######
  #####......#####..#.#.#..#..#.##..###....#...###.###......#...#.....#......#####..C..####.....#####.##.#######
  #####...#..##.####.##..##..##....####.####..#.##....#.####...#.......#.......#.......####....#.###.....#######
  #####..###....####..........####..#...........##..G....#....####..............#..#....###.C.....#......#######
  ##########.#...#...#......#...##.###....#.....###..........####.............#........###...........#.....#####
  ##########........#....#.#..G..#####....##.#.#######......#####......#....#.##..#.O..#.....##...O..#.....#####
  #########...........#..........####...##......##........#.####..............#.#.....#####..##..........#######
  ########.....##...G.#.....#...####.##.###...#.......#....###......#.....#...#.......#.....#..##....#...#######
  ########...#.........####.....##...###.....#.#......##...##.##.##.....##.##..........#............##...#######
  #######...##.##..##.#######.......#..###.....###..O.###.###.#####.C....#..#..#......####.####.#...#....#######
  #######.....#.......#..................#....####......#...#...##........#....##...#...######..#.........######
  ########....#..#...####...S.#.S.####....#.######.##..##.G.....##.##.#....##########.C.#######.###.O.....######
  #########..##.#...#.#..#..........#.......###..##.#..##..........##..#..###########...#####...###......#######
  ###########...........#...........##..###....#....................###...###################.+.####....########
  ###########...........#...........###........#....................###....####...#######...#...#####..#########
  ##########.#########..#..#######..##...#.....#############..######.#..#..###..+....####.G.########...#########
  #######..#.........#..#..#.....#..##..##............................#..#.###.......####...########.......#####
  ######.............#..#..#.....#..##..##.#..............S.........##########.......######.########.......#####
  #####........####..#..#..#..#..#..##...##....####..####.....#######.####.###.......######.########......######
  #####.G.........#..#..#..#..#.....##.....#......#.....#.....#..........#.###.......######...............######
  #####....#......#..#..#..#..#.....##..###.......#.....#.....#........##..###.......#######.............#######
  #####...##....G.####..####..####..###.#...C..####..####..####..#..#...##.###.......#######.........#....######
  #####....#.........#.....#.....#..######........#..#..............#.#....#####...#########........#....#######
  #######.......S....#.....#.....#..######........#..#..........G....#.....#######.###................##.#######
  ########........#..####..##....#..#######..###..#.....#######...##.....##...####.###.#####..........##..######
  #######......#..#........#..C..#..####.#.....#..#.O.........#......#....#.G.####.###.###.....#####.#....######
  #####........#..#........#.....#..###....#...#..#...........#.........#.....####.###.##......######......#####
  #####........#..##########..#########.O..##..####..#..#..####..###....#.O.######.###.##......######.....######
  #####....................#........###.....#........#..#........#..##.#....######.###.##.......####.....#######
  #####..##.....+..........#........###..####........#..#........#..#####.#####........##.....C.####......######
  #######.#.......#..####..####..#..##.#..#.#.....#.....#..####..#..######.####........##.......####......######
  ######..........#..#..#.....#..#..##...#..#...C...G...#..#........###.#..####........##......#####.#.....#####
  #####...........#..#..#.....#..#..##..#.#.#.#########...#########.###.#..####........##......#####.......#####
  #####......###..#..#..####..####..##.#.....##...................#.###....####........#################...#####
  #####..............#..............##.###....#.C...............O.#.#.......###........#############..##...#####
  #####.........S....#..............##.#.##...#...................#.#.+...G.###........#############.###...#####
  #####..#...##...####################.#....#.#...................#.........#..#.##.##.##..#.#....##.####..#####
  ##########.#########################..#.....#...................#.......#.....#...##.##.#....##....###########
  #####...##.#.#.....##...................#...#...................#..........#.....##...#..........#.###########
  #####.+.#..#..#.#.###.......+.....#.#.....G.#.........+.........#....#..G..#.#...#..###...###.##...#..########
  #####............###............#...###.....#.........@.........#...#.......#.....#..###...##...#.##...#######
  ########..#..###.##.#.#.....#.S....#.##..##.......................#.#....#..#.G.......##.#####.###.....#######
  ######........##......#..#..#......#.#.....#........@.&.@........##...##.#.##.........##....#..##.#....#######
  #####....##.C.#........###..#.#...##.###..#...........m..........#...#......##......C.####...#.#..#.....######
  ######...#........#...........#.......#..####.........@.........#.#..#..####.#........####.....##.......######
  #######.........#..##.G.#...#.####....#.....#........a=r........#..##..#####......+.#...#.##..##....S...######
  ########.#.##..#...##.....###.###.......##..#.........t.........#.......#....#............#.............######
  #######.#######....##..#.######.....##..##..#...................####..G.##.....##...###..#..###....#..########
  ######......#....#..#.####.###..###....####.#...................#####...##.##.##...##.....#######.#..#########
  #####.....O...O.....#.###...##.##.....#..####...................#...#...#####...#..##.##....#..####..##..#####
  #####.............#...###.#....#...#.....####.G...............S.#.#.#.....#..........#.##...#..#.........#####
  ########.#.#...######..#....#...###...#..####...................###..#..###.#..........##......##........#####
  ########.#.#.#####.###...#...#..#.........###.#######...###########.......##............#...#####.#.##..######
  ######....##.#####.###...#..###....#..#.+.###.....#####....##.#.##.......###.............#..#####...##########
  ######......##.#.#....#.#....###...#.##...##.....#######...#..#.........###..........#######...#....##########
  ######....S.##.#......#.#.#..#.##..#####.#....G.##########.#..#.+.......####..#......#######......############
  #######.#...##..........#............###..#.....##...###......#..........#.#.........#..##.........###########
  #######.##..##..##...#..#.#..###.#.#####.###########.........####.....#...........#....###.....#....###..#####
  ######..#.......##...#..#.#..#.#.#..........#######.......#.#####....##....##......#...####...#....###...#####
  #######..###.#..##...#....#......#..G.....G.#####.................######.#......#.##...#####..#....###..######
  ###########..#..##...#....#.................####......#...###....###.........##...##..#######...#...#...######
  ######...###....##...#....#...G.....##....#######...O.#.#.###.....#.........##....###.#######.G.........######
  #####.....#.....##..................##.#..##.....................#............#.#..#..#.#...............######
  #####......##...##...........##..#..##....####..###.#..#....#..#...........##.#...##....#####.##..#...########
  #####......##..###......#..#.#...#.#..#....####...........##...............###....##..####..####.....#########
  ######...#####.###........##.#.#.....#..G.#.......C.S.####..........S.....####..O.#######.....##......########
  ######...#####.###......#....##.....#.....#######.....##....####.#........####....##..######............######
  #####......###.###......#.#..#..#.G..#.#.#.######..######..#####...#.....##..#....###.#####...........C.######
  ######.....###..##......#..##..##...#.###..........#####....#...#.........#...#..####.####.#............######
  ######....###...#....#..#####..#.......................####.........G..........#..#.....##.#.......#..G..#####
  #######....#.........#...###..................###...#..#..##.##.............#..#####..#..................#####
  #######.G..##...........#.##.####.#.##..#....####.#......###.###............#.######........##..#......#######
  #######....##...##......#...#####.#####....#.######.#...........##..#...........###.....#...###..#....########
  ########..##..............G.##..................######........#######.#....#..#..###.#....S..##..#...#########
  #######...#.................#....................##.##..##......######...###...####..##........####...########
  #######.G..................####...................#.#..#####..#.#######..##....#.####...#.....#####...########
  #######.........#...........#.........###.#....##.........##..###...####.###..#.....##.##...#.#.##.....#######
  #########......##...........#.+.##.#..#........####.+.....#..###....#..##....#....#...########..#.#.....######
  #########..#....##......#####...##....##.......####...........##.....#.....#..##...#.#######.......###...#####
  #########.##....##.......#####......####.......#....####....G..#.........#...#####..###..#..#.......##...#####
  #####..#........##......##......#..####....#.......####.........#...#######....##....##.###....##..##....#####
  #####....##.#...##......###..#.#...##....###.#.#...###.#......###.#########.C.####.#.##.......######.....#####
  #####.....#.#...##...#..###....##..####.#.................#..####....#...##...####......##..#...#.##.##.######
  #####......#....##..##.####.G.##..###..####......####.....##.#..###.####..###...##......##.#..G......#########
  #####...####....##..#######...#####..#.#######.#..###...#..#......######...###....###..................#######
  ############.##.##.####...#.########........#.....#.##..#...##..###..##.#..#..##..####.###...##.#.#.....######
  #######.....#...#####....#.########.##..#.........#..............#......#.........####.####.............######
  ######..G.S.....#####.G.##.########..#..##...#....#..###....G...#.....S.........#..#..#..##............#######
  #####...........#####...##.#######...##.......#................###............##........................######
  #####..#.....##.###.............................+....##........#####..#......####...............####.....#####
  #########..####.#...##..###....##...#...#######...#..####.......#######.......##....##..........######...#####
  #################.S.#######.G.##......#########.###..####........######.......##....##....#.....######...#####
  #################...######....#......##########..########..##...#########..#..###..#####.###..################
  ##############################################################################################################
  ##############################################################################################################
  ##############################################################################################################
  ##############################################################################################################
  ##############################################################################################################
char_to_map_name:
  "#": wall
  ".": empty
  "@": agent.agent
  "+": junction
  "&": hub
  "=": chest
  "G": germanium_extractor
  "S": silicon_extractor
  "O": oxygen_extractor
  "C": carbon_extractor
  "a": aligner_station
  "r": scrambler_station
  "m": miner_station
  "t": scout_station
