type: mettagrid.map_builder.ascii.AsciiMapBuilder.Config
map_data: |-
  ##################################################
  ####..######...........##########...........####.#
  #.###.####.............######.#......@.....#.....#
  #..##........###.........####.#...@..@....####...#
  #....#.......###.........#####.............##....#
  #...###......###...........#......@......#..#....#
  #....#.....................#.........#...#..##...#
  #..###..............................###....#.#...#
  #.####.........##....................#...........#
  #..#...........##.....................####.#.....#
  #.............##.......#..............####.#.#...#
  #.............##......###...#.........####.#.....#
  #...........#.###......##..###........####.......#
  #...........###.#......###..#...........###......#
  #...........#.###.......#.............####.......#
  #...........#.###.###....................#.......#
  #...........####..###.................###........#
  #.......#.....#...###.................####.......#
  #.......#........................................#
  #.....#####.......##.......................#.....#
  #.......##........##......................###....#
  #......#####...............................#.....#
  #........#..............................##.#.....#
  #..###.#.#.........##...................######...#
  #..##.........###..##....##.###............#.....#
  #..#.###......###.......#.#####............#.....#
  #..#####.#....####.......######...###............#
  #..###.#.#......#.......#####.....###............#
  ######.#####.......#......#####...######.........#
  #..#.....#........###..............##..####......#
  #..#.....#.........#..............####.####......#
  #......................####.......#########......#
  #................##...###.#.......####.####......#
  #................##...###.........####...........#
  #......................#.##......................#
  #............#........###........................#
  #...........###.......##........####..........####
  #............#.....#.##.........#####.........####
  ######......#####..#........#####.........########
  #..............######.........#...#...........####
  #....=...........####........###..#............###
  #..............#..##.#.#......#....####..........#
  ##################################################
char_to_map_name:
  "#": wall
  ".": empty
  "O": oxygen_extractor
  "G": germanium_extractor
  "+": junction
  "C": carbon_extractor
  "S": silicon_extractor
  "@": agent.agent
  "&": c:hub
  "=": c:chest
  "1": c:chest_carbon
  "2": c:chest_oxygen
  "3": c:chest_germanium
  "4": c:chest_silicon

