type: mettagrid.map_builder.ascii.AsciiMapBuilder.Config
map_data: |-
  #########################
  #G.......+++.+++......S.#
  #...........=...........#
  #.......................#
  #..........+.+..........#
  #.......................#
  #.......................#
  #.......................#
  #.......................#
  #.......................#
  #.......................#
  #.......................#
  #.......................#
  #..........#.#..........#
  #..........#.#..........#
  #..........#.#..........#
  #..........#.#..........#
  #..........#.#..........#
  #..........#.#..........#
  #..........#.#..........#
  #........###.###........#
  #........#@...@#........#
  #........#..&..#........#
  #........#@...@#........#
  #........#######........#
  #.......................#
  #.......................#
  #.......................#
  #.......................#
  #.......................#
  #.......................#
  #.......................#
  #.......................#
  #.......................#
  #.......................#
  #.......................#
  #.......................#
  #.......................#
  #.......................#
  #.C.......++++++......O.#
  #.......................#
  #########################

char_to_map_name:
  "#": wall
  ".": empty
  "C": carbon_extractor
  "S": silicon_extractor
  "O": oxygen_extractor
  "G": germanium_extractor
  "+": charger
  "&": hub
  "=": chest
  "@": agent.agent
  "1": agent.agent
  "2": agent.agent
  "3": agent.agent
  "4": agent.agent
  "?": empty


