type: mettagrid.map_builder.ascii.AsciiMapBuilder.Config
map_data: |-
  ##############################################################################################################################################
  ##############################################################################################################################################
  ##############################################################################################################################################
  ##############################################################################################################################################
  #################################################################################CCC############OOO#########SSS#################GGG###########
  #################################################################......C................................................................######
  #################################################################.............................C...............................+.........######
  #################################################################.......................................................................+#####
  #################################################################.G...###########.......................................................######
  #################################################################.....###########.......................................................+#####
  #################################################################.....###########................######...######........................######
  #################################################################.....###########................#.............#........................######
  #################################################################................................#.C.........O.#......S.................######
  #################################################################................................#.............#..............C.........######
  #################################################################........S.......................#......+......#........................######
  #################################################################................C...............#......@......#........................######
  #################################################################.....####..............................................................######
  #################################################################.....####............................@.&.@.............................######
  #################################################################.....####................O.............................................######
  #################################################################.....####.......................#......@......#........................######
  #################################################################...............#................#......=......#..............C.........######
  #################################################################...#....###.....................#.............#........................######
  #################################################################......##....#.#...............#.G.........S.#....S.....................######
  #################################################################....##....##...................#.............#........................#######
  #################################################################.G.#########..##................######...######........................######
  #################################################################.......#.......#.......................................................######
  #################################################################...............#.................O........................S............######
  #################################################################........O..............................................................######
  #################################################################................O.......+..............................................######
  #################################################################...............#.......................................................######
  #################################################################.......#.......###.....................................................######
  #################################################################.....#.....#...###.......C........C....................................######
  #################################################################.......##......##..##........................#####............#........######
  #################################################################......#.......######.##..#..................#####.........#........#...######
  ##############################################################################################################################################
  ##############################################################################################################################################
  ##############################################################################################################################################
  ##############################################################################################################################################
  ##############################################################################################################################################
char_to_map_name:
  "#": wall
  ".": empty
  "O": oxygen_extractor
  "G": germanium_extractor
  "+": junction
  "C": carbon_extractor
  "S": silicon_extractor
  "@": agent.agent
  "&": c:hub
  "=": c:chest
