type: mettagrid.map_builder.ascii.AsciiMapBuilder.Config
map_data: |-
  ##############################################################################################################
  ##############################################################################################################
  ##############################################################################################################
  ##############################################################################################################
  ##############################################################################################################
  ##############################################################################################################
  #########.##...##########..###...###########...##############.################################################
  #########.##.+.##########..###.S...#########.G.########.####...################################.##############
  #########.##...#########...###......##...###....#######.######.################################..#############
  #########.##.##.#######.....##.#######.+.######.#######.######.################################..#############
  #########.##.##.######....#..#.#######...######.###..#..#.####.##..#..#####.#####.###.##..###......###...#####
  #########.##.##........S......................#.####.#..#..##..#..#....##....###..###..##.....##...###.O.#####
  #########.##.##...........#..........##.....###.####..#.##.###......#...#.######.##.#..#####..#...####...#####
  #########.##.............###......#.###.........#####.#.##.###..#.....##..#......#.....#####..##....##.#######
  #########.##......##.....####.....#####......##.#.##....#..#.#...........#......#.....####.#..#..#...#.#######
  #########.##.#....###....##..#....######..#...#.#.#..........#........##...###..#....##.##....####.O.#.#######
  #########.##.#....##..##.....#.#....###.......#.#..##.#....#.#..............##.......#..###.#.#.#......#######
  #########.##.##....#####.O.###.#########......#.#..........#.#....#....#.#..............###.....#.#.##########
  #########.##........##.....###.#########......#....#..#.##.#.#........##.#..#....##...###.......#.#.##########
  #########.##.O...#...#....####.########..C.........##.#.##.#.#...#...##..#............####..#.#.#...##########
  #########.##.........#....####.#......#............##.#....#........##...#....###........##...#.#.#....#######
  #########.#..#.......#....####.#......#...........##..#.#..#.#.........................G...#..#...#..S.#######
  #########.#..#.......#....####.#......#.........#..##.#.##.#.........................#......#..........#######
  #########.#..........###.#####.#......##.....#.....##.#.##.#.....#.#...........#......#.#..#........##########
  #########.#..##......###.#####.#...........#..#.....#.#.##.#.#..#..#.............#...####.###......###########
  #########.#..#......####.#####.#######..#.....#.#.....#.##.#.#.#............##...##.#.#.#.###.......##########
  #########.#..##.....####...###.####..........##.#.#.#.#.##.#....................#.....#....##......###...#####
  #########.#...#.....##......##.####...........#...##....##.#...#............#.......##.....##......###.+.#####
  #########.....#....#...........#.........#...##...##....#..........................###.....#.......###...#####
  #########.....#.....##.......+.#.######......##....#.......#.#.......................###....#......###..######
  #########.#...#......#.........#.######......#....###.#.##.#....................##..#######........###..######
  #########.#......S...#...........##........G.#....###.#.##.#.S...............##.....#####.#.......####..######
  #########.#...#......#####.###.####..........##...###.#.##.#.................##..#...###..##........##.#######
  #########.#..........#####.###.####.....#....##...##..#.##...................##..#.#.#.##.........###..#######
  #########.#..........#####.###.####....#.....##...###.#.##.#.#.............###.....###.#....#.....#...########
  #########.#...#.......#.##...................##...###.#.##.#.#.............##..##.##...#..#.#.......#.########
  #########.#...#......................#.....#............##.#.#............##....#......##..........#..########
  #########.#...#.......................#...........#.....##.#..............##....#.....#...#.#......#.#########
  #########..........................................#..#.##.#.........#.........##..#..###.........#..#########
  #########...........#........#......#........#......#.#.##.#.........#.....G..........###...........##########
  #########.........#..........#...............##.......#.#..#........................######.........###...#####
  #########.......##....####.###.#.#####.##..####....#..#.#..#............................#...........##.+.#####
  #########.....#.#####...##.###..##..####....###.......#.##.#...#############.....###..####.........##....#####
  #########.....#..##.###....###...##.##...S..###...#...#.##...#.##########.##.C.S.#########.........#..########
  ########......#........##......###.........####...###....#......########..##.....###########.........#########
  ########...........#.+.#.....#.####.....##.###....####.+......#.#######...###..#############......############
  ########..........#.....##.#.#.#####..............####...#...#...####......##...############......############
  #########.............#..#.#...#######.##.######...##......###.+.###...#.G.###..###########.......############
  #########........####....#.#...#########.....................#........##...###..########...##......###########
  #########.......#######....#...####.####.+.#.....C.........O.#.##....#########..########.C.##......###########
  ########........#######....#...###...###....##.#.............#.#...###########...#...###...#.......#...#######
  ########........##...###...#...###.G..#.######.#......+......#.##..############..#.O.###..#.#......#.G.#######
  ########........#.##.#.....#...###...#...####..#......@......#.################......##................#######
  #########.........##.#.S...#...#####.#.+.######................####..##########..G.########........G.#########
  #########.........##.#.....#...###.#.#...#####......@.&.@.......###.#.##########...##..####..........#########
  #########.......####..##.#.#...###....##................................########..##..#.#.#........###########
  #########........####.##.#.#...##....######..#........@......#..###########.####.#....#.#.##.......###########
  #########.......#####.##...#...#.....######..##.......=......#.############.####.#.O..#.....#......###########
  #########.......#####..##..#...#.....##########..............##############.###..#....##..........############
  #########.......######.......C........##########.G.........S.##############.###.##.+..##....#.....############
  #########.......##########.....######.##########.............##############.###.##................############
  #########.......##########...########.###############......###....#########.###.####...C.####.....############
  #########.......##########...########.####...######...............#########.###.####.....####.....############
  #########.......#####################.####...#############..#...................####..#######.....############
  #########.......##########............####.......########...###.....###########.####..#######.....############
  #########....##.##########.#######.O.........#.+.########..########.###########.####..#######.....############
  #########.......####....##.#######...#####...#...########..########.###########...................############
  #########....O..####....##.#########.#####...###########...#######........###################.....############
  #########.......####....##.#########.#####.....#########..#########.......################........############
  #########..O.##.........##.#########.#####.#....########..##########......################.O......############
  #########....#######....##.#########.#####.###...#######..##########......################...............#####
  #########....#######....##.#########.#####.####....####...##############.####################.....####.+.#####
  ####################.......#########.###...#####....###..###############.####################.....####...#####
  ####################....############.###.S.#######...##..###############.####################.....############
  ####################....#####........###...########......###############.####################.....############
  #############################.######################..................##.####################........#########
  ##########...################.######################..................##.####################.######...#######
  ##########.O.################.#####################......############....####################.######.+.#######
  #######...........###########.####################...##..####################################.####.....#######
  #######...........###########.##################....###..####################################.####.S.#########
  #######...........########.........############....####...####################...############.####...#########
  #############.############.+..##.O.###########...#######..####################.O.############.################
  ##########....############....##...#########....####......##########.............############.################
  ##########.S..###############.#############....#####.S.#..##########...........##############.################
  ######........###############.#############..#######...#...#######.............#######...####.################
  ######.+.####.###############.#############.#############..#######.S...........####....+.####.################
  ######...#....####...########......########.#############..######..............####................###########
  ##########.+..####.G.########.##.G.########.#############...####...............####....#####.###.S.###########
  ##########....####...########.##...###......########...###..####...............####....#####.###.....#########
  #############.####.##########.########.+.###########.+.###.....................####....#####.#####.G.#########
  #############........................#...###########....###########################....#####...###...#########
  #############.####.S.#########.###.G.##################.###########################..S.#####.G.###############
  #############.####...#########.###...##################.###########################....#####...###############
  #############.################.########################.###########################....#######################
  #############.################.###################...##.###########################....#######################
  #############.################.###################.+.##.########################..........####################
  #############.################.#############...###...##.######################...########...##################
  #############.#############..................+.###.####.######################.############.##################
  #############.#############......................................#########.....############..#################
  #############.#############.................###............###.S.#########.S.###############...###############
  #############.#############.................###............###...###...###...#################.###############
  #############.#############.####.O.+.##########............#########.G.#######################.###############
  ############...#########....####.....###################...............#######################.......#########
  ############.O.#########.S.#############################.S.#######.S.#############################.O.#########
  ############...#########...#############################...#######...#############################...#########
  ##############################################################################################################
  ##############################################################################################################
  ##############################################################################################################
  ##############################################################################################################
  ##############################################################################################################
char_to_map_name:
  "#": wall
  ".": empty
  "+": charger
  "S": silicon_extractor
  "G": germanium_extractor
  "O": oxygen_extractor
  "C": carbon_extractor
  "@": agent.agent
  "&": hub
  "=": chest
