type: mettagrid.map_builder.ascii.AsciiMapBuilder.Config
map_data: |-
  ######################################################################
  #.....G...O..........................&........+..S...O........+......#
  #.....#.......S.........#..O...S....................................&#
  #..#................#..........................G.....................#
  #........=...........................................................#
  #.....................................................=..............#
  #.C..........#.........&.+..C................+.......................#
  #.......&..................+......................#.....G............#
  #....#...........................................S...................#
  #.............#.......S.......S.O........................&...........#
  #.......................S.......................C............#.......#
  #.........#.....&.....C..+...#...........#..#..#.#.##.#.#.&#.........#
  #.........#....+#.S........&..............O...O..+##...#.O.#.......O.#
  ###..S...&#..#......................O..............#..+.##.#.........#
  #..#......#...........C............&.............#.#...##+.##.....+..#
  #....O......C..+#..............=..#.#......#....&#.+..#....#.#=.&....#
  #.........#...............#.............+.......#.###.###..#.##......#
  #.........#....#......#......#.S..............#....#.#####.#........##
  #.......&##....O#..........#......................#####....#.........#
  #.........#.....#...............C..#..........S..####+#....#.........#
  #..........G......#.C...O..........G..#..#.C....#..#.#..#.#......#...#
  #.........C........#...................##.................=##G.......#
  #.....&................................#...................#........&#
  #.........#......#.....+.#....@@@@.................C.......#.......#.#
  #.=.......#.G#.......##.#.###.......+..............................#.#
  #.........#...........+.........................#O........=..........#
  #..S...#..#+.............+.#.....#....G...........+...S.......S#.&...#
  ##....O...#...................&............G..#O...#..G...S#G........#
  #....S....##.C#....#.......##..............#+#..##+.#....#...........#
  #.........#..............=.+..G................#...#.......#.........#
  #.......................G...........................&....#..........+#
  #=..S.....S.....&......................G.S..&..............#.........#
  #.........#...+.......=....S..O.....+....S.......#...=.....#...S.....#
  #..&.....G#...##............................&..+........C..#.=.......#
  #...#...#.##.####....G........O...............#............#S........#
  #.........#.G...........#..&.............S.............=...#.........#
  #.#...+.#.#..=#.............&.O......S........C..S#..#.....#........S#
  #=.................+.....................+.....S......#...S#....C..G.#
  #.................+........................................#...O.+...#
  #=.....&..#............#...........................G.##.#..#.........#
  #.........#O.#............O...CC................O......G#..#.........#
  #.C.#.....##....+.......#............&.........G...........#.........#
  #..=......##...........................&......#...+........#.....+...#
  #....+....##.....+.......................#.................#.#&....#.#
  #.....G......C..........#.........O.....#..#..........&....#......C..#
  #.#.....+.##.........................C.................#...#..#.&....#
  #.........##..#.#..........................................#.........#
  #&........##.+#.........=.......G.#.#......#.C.........&...#.........#
  #.........#.+..#......C..........#...+..........+.....#....#........##
  #......=#.#+.................#......#..#.#...#.....G......=#.........#
  #.....G...##......&...........C.#......+....#....#.....##.##.........#
  #.........#....+...................#+.#....#.#.............#......O..#
  #..S..##..##...............#........##O...=.+...#O.........#.........#
  #.....#.......G....G.......#........+...............+.=....#.........#
  #...................#..#....&....O..#....#......G........#.#.........#
  #............S.S....#........+..&..........................#.........#
  #.........#G.....&.C.......=.......#...........#.......+..=#.........#
  #.........#.........................S.....=..............O##.......S.#
  #O........#+.#......#....+..........................+.....+#........##
  #..........................................#......O....=.............#
  #....#...=.......................=.........#.........................#
  #..........C........#....&.....#.....#..#.O.......#......G....S.....C#
  #...........=................................#..........=............#
  #...G..G...................=.............................C...........#
  #.................................#...O..+.............#.............#
  #................O...G....................G...................C......#
  #....#................#......C.................+...........#...#.....#
  #....................=.....................#.&................C......#
  #...#..=....#.....+.....G.......&....................................#
  ######################################################################
char_to_map_name:
  "#": wall
  ".": empty
  "@": agent.agent
  "+": charger
  "&": hub
  "=": chest
  "G": germanium_extractor
  "S": silicon_extractor
  "O": oxygen_extractor
  "C": carbon_extractor
