type: mettagrid.map_builder.ascii.AsciiMapBuilder.Config
map_data: |-
  ###############################
  ###############################
  ###############################
  ###############################
  ###############################
  #####.....................#####
  #####.....................#####
  #####..C...............O..#####
  #####.....................#####
  #####.....................#####
  #####.....................#####
  #####.....................#####
  #####..........+..........#####
  #####..........@..........#####
  #####.....................#####
  #####........@.&.@........#####
  #####.....................#####
  #####..........@..........#####
  #####..........=..........#####
  #####.....................#####
  #####.....................#####
  #####.....................#####
  #####.....................#####
  #####..G...............S..#####
  #####.....................#####
  #####.....................#####
  ###############################
  ###############################
  ###############################
  ###############################
  ###############################
char_to_map_name:
  "#": wall
  ".": empty
  "C": carbon_extractor
  "O": oxygen_extractor
  "+": junction
  "@": agent.agent
  "&": c:hub
  "=": c:chest
  "G": germanium_extractor
  "S": silicon_extractor
